NO maps/north.png

SO  ./maps/south.png

EA  maps/east.png
WE  maps/west.png
    C    0 ,  125,255
                 
 F       255 ,50,0


1111111111111111111111111
1000010000110000000000001
1111110001110000000000001
101000000000000N000000001
1111111110110000011100001
100000000011110000011111111
11110111111111110111000001111111
1111111111111111111111111